                 
                 
    ##########   
    #        #   
    # .    . #   
    #        #   
    # $      #   
    #    $   #   
    #    #####   
    #  @ #       
    #    #       
    ######       
                 
