                 
                 
                 
     #######     
    ##     #     
    #  *.$.#     
    #  *.#.###   
    # #$@$$  #   
    #   ## # #   
    ######   #   
         #####   
                 
                 
