                 
                 
     ####        
   ###  ####     
   #   @   #     
   # #. .#.###   
   # $$$ $$$ #   
   ###.#.#.# #   
     #       #   
     ####  ###   
        ####     
                 
                 
