                 
                 
    #########    
    #. .    #    
    #.$..   #    
    ## ###@ #    
     #  $  ##    
     # $$ ##     
     #  $ #      
     #  ###      
     ####        
                 
                 
